1111111111111111111111
1C10001011101110101111
1010101111111111111011
1000000P000000000C1111
1011101011111N10111011
11111110111010100C1011
1000111011111010111011
1C101N1011111110101011
1110111010001010111C11
1N00C00C101010N00000E1
1111111111111111111111
